1111111111111
10C10000000C1
10000111V1001
1P0011E0000C1
1111111111111