111111111111
1P0000000C11
111111101101
100001001C01
101000101101
10C1D0000101
111110111101
10000000D001
111010111101
100C10001E01
1100001D1001
111111111111