111111111111
1P0000000C11
111111101101
100001001C01
101000101101
10C100000101
111110111101
100000000001
111010111101
100C10001E01
110000100001
111111111111