



1111111111111
10C10000000C1
1000011111001
100011E0000C1
1111111111111

