



1111111111111
10C10000000C1
1000011110011
1P0011E0001C1
1111111111111

