



1111111111111
10C10000000C1
1000011111001
1P0011E1000C1
1111111111111

